1111111111111
10010000000C1
1000X11111001
1P0011E0000X1
1111111111111