1111111111111
10010000001C1
1100011111001
1P1011E001001
1111111111111