111111111111111
1P00000000000C1
101111011111101
100001010000001
1C111C101111101
10000001E0000C1
111111111111111