111111111111111
1P00000000000C1
101111011111101
100001010000001
1C1110101111101
1000000100000E1
111111111111111