1111111111111111111111111
1P000001000000000000000C1
1011111010111111111111101
1000000010100000000000101
1110111010101111111110101
1C00000100010100000100001
1011111111110101111010111
1000000000010101000010001
1111111111010101011111101
1C000000000000000000000E1
1111111111111111111111111