1111111111111111111
1P000001000000000C1
1011111010111111101
1000000010100000101
1110111110101110101
1C001000000E1000101
1011110111111101111
100000000C000000001
1111111111111111111