1111111111111111111111111
1P000001000000000000000C1
1011111010111111111111101
1000000010100000000000101
11101110101E1111111110101
1C0000010001C100000000001
1011111111110101111010111
1000000000010101000010001
1111111111010101111111101
1C00000000000000000000001
1111111111111111111111111