1111111111111
10110000000C1
1001011111001
1P1000E000001
1111111111111