111111
1P0001
111101
1C1111
1E0001
111111