111111
1P0001
111101
1C0111
111E11
111111