111111
1P0001
101101
1C0111
111E11
111111