111111
1P0001
111101
1C1E01
111111