111111111111111111111111111111111111111111111111111111111111111111111111111111
100000000000000C00000000000000000000000000000000000000000000000000000000000001
1P00000000000000000000000000000000000000000000000000000000000000000000000000E1
100000000000000000000000C00000000000000000000000000000000000000000000000000001
111111111111111111111111111111111111111111111111111111111111111111111111111111